sq	AL
ar	SA
be	BY
bg	BG
ca	ES
zh_CN	CN
zh_SG	SG
zh_HK	HK
zh_TW	TW
hr	HR
cs	CZ
da	DK
nl	NL
en	US
et	EE
fi	FI
fr	FR
de	DE
el	GR
iw	IL
hi	IN
hu	HU
is	IS
in	ID
ga	IE
it	IT
ja	JP
ko	KR
lv	LV
lt	LT
mk	MK
ms	MY
mt	MT
no	NO
pl	PL
pt_BR	BR
pt_PT	PT
ro	RO
ru	RU
sr	RS
sk	SK
sl	SI
es	ES
sv	SE
th	TH
tr	TR
uk	UA
vi	VN
